11111111111111111111111111111111
1E00X0000000X00C00000C0000000001
10100101001000001010010000010101
101001001010101000100100X0010101
1P0000000C00C000X0000000000000C1
11111111111111111111111111111111
